TILEMAP
40 28 							-- Size of tile map in tiles
16 32 							-- Tile size & block size
images/blocks.png 	-- Tilesheet
2 2 								-- Number of tiles in tilesheet
1111111111111111111111111111111111111111
11                                    11
11                                    11
11                                    11
11                                    11
11                                    11
11                                    11
11                                    11
11                                    11
11                                    11
11                                    11
11                                    11
11                                    11
11                                    11
11                                    11
11                                    11
11                                    11
11                                    11
11                                    11
11                                    11
11                                    11
11                                    11
11                                    11
11                                11  11
11                                24  11
11                                34  11
11                                11  11
1111111111111111111111111111111111111111

