TILEMAP
222 28 							-- Size of tile map in tiles
16 32 							-- Tile size & block size
images/vacio.png 	-- Tilesheet
2 2 								-- Number of tiles in tilesheet
111111111111111111111111111111111111111111111111111111111111111111111111111111111111111111111111111111111111111111111111111111111111111111111111111111111111111111111111111111111111111111111111111111111111111111111111111111
11  11111        11          11111111111       111111111111111        111     11111111111111                     1111111111  1111111111                                                                                     11
11   1111                      1  1  1         111111111111111        111     11111111111111                     1111111111  1111111111                                                                                     11
11   1111                                      111111111111111        111     11111111111111                     1111111111  1111111111                                                                                     11
11   1111                                      111111111111111        111      1 1 1 1  1111                     1111111111  1111111111                                                                                     11
11   1111                                      111111111111111        111               111                      1111111111  1111111111                                                                                     11
11   1111                                      1111        111        111                1                       1111111111  1111111111                                                                                     11
11   1111                                      1111        111        111                                        1111111111  1111111111                                                                                     11
11   1111                                      1111        111                                                   1111111111  1111111111                                                                                     11
11   1111                                      1111        111                                                                                                                                                              11
11                                                                                                                                                                                                                          11
11                                                                                                                                                                                                                          11
11                                                                                                                                                                                                                          11
11                                                                                                                                                                                                                          11
11                                                                                                                                                                                                                          11
11                                                                                                                                                                                                                          11
11                                                                                                                                                                                                                          11
11   1111                                                                                                                                                                                                                   11
11   1111                                                                                                        1111111111  1111111111                                                                                     11
11   1111                                                                                                        1111111111  1111111111                                                                                     11
11   1111                                                  111        111               1                        1111111111  1111111111                                                                                     11
11   1111                                                  111        111              111                       1111111111  1111111111                                                                                     11
11   1111                                                  111        111              1111                      1111111111  1111111111                                                                                     11
11   1111          111                         11          111        111     1 1 1 1 11111                      1111111111  1111111111                                                                                     11
11  11111          111         1  1  1         11          111        111     1111111111111                      1111111111  1111111111                                                                                     11
11  11111          111       11111111111       11          111        111     1111111111111                      1111111111  1111111111                                                                                     11
11  11111          111       11111111111      1111        1111        111     1111111111111                      1111111111  1111111111                                                                                     11
111111111111111111111111111111111111111111111111111111111111111111111111111111111111111111111111111111111111111111111111111111111111111111111111111111111111111111111111111111111111111111111111111111111111111111111111111111

